color	description
s	s
ash_white	Ash White
cotton	Cotton
dark_white	Dark White
egg_shell	Egg Shell
floralwhite	Floral White
ivory	Ivory
lavenderblush	Lavender Blush
lavender_pinocchio	Lavender Pinocchio
light_white	Light White
linen	Linen
milk_white	Milk white
off_white	Off-white
oldlace	Old Lace
pearl	Pearl
pearl_white	Pearl White
rice	Rice
seashell	Seashell
snow	Snow
soft_ivory	Soft Ivory
whitesmoke	White Smoke
white	White
white_chocolate	White Chocolate
